15 15
100 100
2 2 2 2 2 2 2 2 2 2 2 2 2 2 2
2 0 0 0 0 0 0 0 0 0 0 0 0 0 2
2 0 2 2 2 2 2 2 0 2 2 2 2 0 2
2 0 2 0 0 0 0 2 0 2 1 1 2 0 2
2 0 2 2 2 2 2 2 0 2 2 2 2 0 2
2 0 0 0 5 2 3 2 0 0 0 0 2 0 2
2 0 2 2 0 2 2 2 2 2 2 2 2 0 2
2 0 2 2 0 0 0 0 2 2 1 2 2 0 2
2 0 2 2 0 2 2 0 2 2 2 1 2 0 2
2 0 2 0 0 0 2 0 0 0 0 0 0 0 2
2 0 2 2 2 2 2 0 2 0 2 2 2 0 2
2 0 2 0 0 0 2 0 2 0 0 0 2 0 2
2 0 2 2 2 2 2 2 2 2 2 0 0 0 2
2 0 0 0 0 0 0 0 0 5 0 0 2 0 0
2 2 2 2 2 2 2 2 2 2 2 2 2 2 2